







NO textures/test/north.xpm








SO textures/test/north.xpm
                        WE textures/test/north.xpm
        EA textures/test/north.xpm

        F 2,           																																																																																																																																																																																												 20,             20
C 200,          200,200

11111
10001
10E01              
1001
11111               

        





















